xeq: mqb gzn
khz: wfb nto eqo lju
mbe: rys jel uhg
tak: kox wky rdl haf nun pvd cgp mar vbx utf ear ydm ltj pac kkg owa zwh
hwz: zdi lbp hbi
uxb: ose
vmm: fga
uvv: hiu
hdp: igc qtz
niw: sbo eqs uni
uim: vbl zxp xcu
wnw: tgd
eop: fed glg jqn
ngf: bmm xxt
fed: yad xvt aek
eli: hkn dwl fqs
hks: tgd
dne: ook
zdi: ucr
ujc: ibc fcv
kel: wmk dyx txj mmd ngf
roq: wnc
ogj: sji xeq
amx: mct pec lvm dac iiv
etj: out
fgs: xyi hhg sth sje
iim: you sus
pyo: rjv
wnh: toi
ery: uhg mgv
snx: cnb adq ydx
uec: otg
lgg: tcm ucq ihk khe
ydm: jxf htq
knb: kxy eli
mwx: soq
cyh: uma lti
xks: spq ptq
tct: cmh gre dwi kmx
tyh: gzt
jdv: fxk oom
sth: tap
ket: inr wyj
ltj: lgg uzr xxp
rfh: ddl
nnu: vbm
mct: rig ygi vxv
wmu: mfi uxb ygw dwx
vaz: sbs
tgd: qsc bzq uti gac mwx tyh pde grw ket oja hrj jzu mvk mwz aid oiu eic rfh
uhs: ogp kxy eli imc
duk: wek cyh pkp zjw pyq vzs rno vos egy hpz xik ibf hxi dye ukk mug vnf qwd
ulw: vyj lcn ysp
rmt: jub aek xvt
eul: els arh tku sxr zgf
eic: gzt wyj inr
cmw: qdc ajq
bmw: dfv jjh bvr
omi: yzw ulv dyc lvs
dlj: pjc eow vbm
kxy: fqs
phv: jzw
uhg: jub caw xvt
aid: ibd gja yxf
qwd: tbw uma
ims: ibd eai
yli: chs fft
xdu: zwh fcn utf mar vbx kiw haf jrx owa kkg pac ltj hhv jsq snh ydm ear cgp pvd nun rdl wky kox
ewk: out
nto: aek
whe: fwf yvz zak ijq
haf: xxp lgg
umx: ytt
cqe: smk
xof: avz ifv
tcz: etj hlb
gzj: vae cte wnc
ail: dyc
mdu: dyc ulv
gss: umx yds
mwz: mfm wfk soa cmw jwt
irj: sxr arh els
kkg: uks fuu pyo
ygd: nxq nhk bmm
ciu: hlb
hkn: riy nfz kfu
xvt: vnt lin dbv unz irk
rno: knb uhs
pse: sbo qzn uni
pat: tku sxr zgf
hbr: fbt tak xdu
ajq: wda gss ldi
bzq: edt fgc
pec: wwn jny ygi
oiu: edt
rdl: uks fuu pyo
per: eeh kmx
uva: otg nkw
xcu: zgf sxr
rbk: fju khz
nhk: fep snz gis myb nzl hwz hra zdz ujc uki hml fws uvv idt xzm
gsd: fwf zak
soa: ajq upx qdc
vkf: zxs zce sri
smk: tku els zgf
rvv: god vcd lkn
lbp: uhr ucr
snh: mog jer cqw eff bux
rmc: out
you: qsc oja uti mvk hrj gac grw eic ldd tyh
bbk: lss yil
wig: rjj
ruc: out
aek: xbj nnu wij aoa vrt fze dbv vnt uve lin ogj rvp joq irk dlj unz
ios: byc dmi
saf: sus
eai: xof csg
oja: mfm
pqg: lmf gjd bbd
sdm: lls ewk
csn: out
jub: nnu wij wmu vrt fze uve vnt lin joq dlj oev unz ygl yli
vos: ocu prx uhs knb
xxp: tcm ihk ucq
mfm: qdc
imi: lcc vby aph yln
mmd: bmm nhk nxq
lmo: pec mct iiv dac
csg: avz lzi vaz
hxi: tbw uma
zpd: gkv sdm iqi
lon: smk vlr
wmk: nxq bmm nhk
vby: lcr yht
zgf: xfk ohi poi top lzd kkz hsn bpz fma hwc vxs rvv ulw pbm pld byk edy
cte: fed
wyh: phv
eeh: out
eye: pqg
kcr: yad caw
fpq: nkw sgp
arq: bvr jjh
ibf: ost rbk fcj ier
pdg: bmm nhk
fuu: hks rjv
lvs: you tgd
pjc: zdw
wcs: fxk
kom: yzw
pde: ios wva rdv
kqd: tlf
zsw: ker daw pqg
ibc: niw pse xuo uzw
ldi: umx yds
rej: tak
qmr: xbz guj ruc csn
bmm: hml dfh ujc zdz hut onq idt hwz gis efj qvp myb qqf
olo: phj sdm iqi
sbt: nxq xxt bmm nhk
sgt: xdu tak fbt
kox: lmo amx
sri: arh els tku zgf sxr
myb: dne duj
ose: xzj djf pdg
vyj: aph yln
wza: jzw vlr smk
sjm: cle vnf ihm vos hfn rno hxi pkp cyh
fws: uml fcr snx
yil: drm
ysp: aph yln
vbm: zdw
byq: sus
imc: fqs
vbx: pyo fuu xmq uks
ijq: cxl hhs
tku: xfk wig ohi poi top hsn kkz lzd bpz rvv vxs fma cuc ulw pbm pld byk edy
zak: kel nyk fso cxl
cma: htq jxf
jzu: lqc yrt jrk
frn: vbl irj
qdc: wda aau gss
nvj: djf pdg xzj
wyj: frj xcr
svr: lxf sjm dxe pgh duk
yrt: aoh
gjd: fbt xdu xvf
qqf: hiu
fjb: afa tct per
els: byk pld pbm yqf ulw cuc bpz vxs fma rvv lzd kkz hsn top poi wig ohi xfk
urw: yad
lxf: zjw cyh pkp wek hpz egy cle rno pyq vzs dye hxi ibf xik hfn qwd ihm mug ukk
toi: gkv sdm iqi phj
eow: zdw lss
spq: fbt xdu
plt: hhg xyi slk
mtf: bmw
xzj: nxq nhk bmm xxt
uzw: qzn
wic: arq bmw rxz
ebo: vae eop cte wnc
nvv: egt
idt: zdi lbp eos und hbi
uzu: vae cte eop
lmf: fbt xvf tak xdu
lcr: fbt xdu tak xvf
ead: eul zzu mja
ayg: akq xuz
loj: niw
vxv: tgd
upx: aau gss ldi wda
ldd: wva ixs ios ddl rdv
fcv: uzw xuo pse niw
pld: imi vyj lcn ysp
lti: kcr
rxz: jjh rmc dfc dfv
mui: lju
adq: zgf sxr els tku
uzr: ihk tcm
uma: uaw
zxs: tku els zgf
hpz: fcj
yxf: dtg csg tnj
lqc: aoh
ear: jpi
txj: nxq bmm xxt
hsn: zsw eye wde
nfm: tgd you
kqj: czw aoh
aau: umx
acm: lvm
iqi: xlc lls
jwt: upx
jxf: wjj utu
vae: jqn
hhs: wmk txj mmd
xyi: tcz
fep: lon
akq: fbt tak xvf xdu
ihm: kjl zxg sya mbe
sbs: owy
mgv: aek xvt caw jub yad
fso: ngf txj dyx wmk
ibd: csg tnj
kkz: vcd god zzh vmm
pbm: lcn imi vyj
zwh: htq
fft: sbt zwd
xvf: wky rdl kox jrx haf nun cgp kiw cma ydm ear mar fcn jsq pac kkg zwh ltj
khe: omi kef
yxr: abb mtf
znc: ijq fwf zak yvz
gre: out
fma: vmm zzh god
ddl: dmi
vty: otg nkw sgp
hxf: hbr hje wqv
phj: lls
pac: goa tkr amx
joq: whe znc gsd
lzd: zsw wde
riy: jub yad aek caw
fju: wfb urw lju nto
jjh: out
pvd: fuu
but: aoh czw ptj
tap: can etj hlb
czw: oqn fjb
yds: guj csn ruc
mhi: erp zkk dtw
edy: xsy fim rjj
dye: ebo ahm roq uzu
hes: zce mgz zxs sri
fxk: nxq xxt bmm
eqs: arh sxr zgf
tlf: sdm phj
toe: jwt cmw soa wfk
htq: nhh
zzu: arh els
pyq: kjl
ogp: fqs hkn dwl
ahm: eop cte
dyt: opy
bmp: sus tgd
tbw: kcr rmt uaw
ocu: kxy imc
fcj: fju khz mui
tys: byq ltq anr bmp ont
pwj: spq xuz
efj: fcr qhf
fga: uva uec zbk fpq vty
xlc: out
qkv: ont ltq byq
zce: tku els
mja: tku arh sxr zgf
lls: out
tkr: mct pec lvm iiv
xnm: ttk iim wnw
cnb: tku arh zgf sxr
otg: fbt xdu tak
igc: byq bmp
qhf: pat cnb ydx
yzw: you tgd sus
xkk: per tct
daw: lmf
xmq: rjv saf nfm
rys: jub aek
can: out
oev: bbk pjc eow vbm
utf: jpi
fcr: ydx pat adq cnb
drn: snx uml qhf
fgc: dhr
dml: out
ltq: tgd
gac: lqc yrt kqj but jrk
cxl: wmk ngf mmd
aoa: vbm bbk
hbi: uhr
bvr: out
ygv: qkv
qtf: nvv xuq sbs whj
rvp: sgq
czd: ker daw
mug: uzu gzj roq ahm
ook: zxp vbl ymf irj
fwf: fso nyk
lss: lkc drm mhi
yad: lin ogj uve vnt dlj oev yli unz nnu wij aoa vrt wmu fze dbv
nzl: phv lon wza
fze: fft
mar: uzr
jsq: dyt xnm abj zci
cgp: pyo
grw: fgc okv edt
vrt: sji ple
drm: dtw zkk erp
sus: ims bzq uti qsc kyn pde grw tyh mwx hrj jzu fsy rfh oiu aid toe
qzn: tku
kjl: jel uhg mgv
rdv: yxr byc dmi
sje: ciu mvf tap rdf
dac: wwn vxv jny ygi rig
uti: rdv
ygw: ose iua nvj
ymf: tku els arh sxr
iua: pdg iek djf zjl
sxr: byk lzd hsn bpz hwc
slk: rdf mvf tcz ciu
ydx: els arh tku
wky: abj zci
goa: lvm dac pec
snz: eos und
diy: sxr
uve: chs
uml: cnb adq ydx
ior: igc qtz qkv
fqs: gzr
tcm: omi ail
dfv: out
hsx: tgd
qtz: ltq
bpz: eye isa
isa: pqg
aoh: xkk oqn eft
kfu: jub yad aek xvt
fcn: acm amx lmo
mgz: zgf
zdw: lkc drm
eff: ygv wob
zxp: zgf els tku
xfk: ysp imi vyj
sgp: xvf
fbt: kox wky rdl haf jrx nun pvd cma kiw cgp mar utf vbx ear jsq snh hhv ltj zwh kkg pac owa
yqf: hxf
dmi: wic mtf eei
xik: sgh prx uhs ocu
wva: dmi
rig: you sus
opy: sus tgd
ifv: nvv
vnt: whe
edt: fgs
nkw: tak xvf fbt
hiu: uim frn
afn: zak iau fwf
zzh: gsr mfp fga
gzt: dfx wnh kqd
pkp: zxg kjl ery mbe sya
mfi: ose nvj
rjv: you tgd
god: fga gsr mfp
lkc: ybw dtw erp
wob: tys igc qtz
sji: mqb
jzw: zgf sxr tku arh
unz: chs sgq fft
hra: uhu vkf hes
nun: acm goa tkr
zdz: vkf
onq: loj
vzs: uma tbw lti
xuz: xdu fbt
uhu: zce mgz zxs diy
dfx: toi olo
egy: ier rbk ost
wij: xeq sji pjz
hut: phv cqe wza
fsy: yrt lqc kqj
hrj: yxf eai
pgh: dye hxi ibf qwd ihm vnf hfn ukk mug zjw cyh vos cle egy hpz rno pyq vzs
ptj: eft fjb oqn
ygl: apo dwx uxb mfi
rjj: xks pwj
dwi: out
eft: per
whj: egt owy dml itg
aph: yht yrr
dlw: out
lkn: gsr
sbo: arh els tku sxr zgf
okv: plt dhr
uni: sxr zgf tku els
yln: yht sgt lcr
gja: tnj
zkk: nhk nxq
yvz: cxl fso
inr: wnh
oqn: per
kef: lvs
jer: ygv wob hdp ior
frj: tlf toi olo
zjw: ier
sya: mgv rys
soq: tnj
jpi: nhh wjj hsx utu
dtg: qtf
apo: nvj iua
pjz: mqb jdv gzn wcs
xuq: egt dml itg
hhv: mog jer bux
xzm: hbi
dfc: out
ocv: xuz bbp akq
xfy: nxq bmm xxt
bbd: tak xdu
tnj: vaz
hwc: isa eye wde czd zsw
gzn: fxk ygd
vcd: fga gsr
hje: fbt
hml: duj
kiw: eff
owa: cqw
caw: oev vrt wmu fze ygl yli ogj nnu wij aoa dlj
uaw: yad jub
ple: gzn jdv wcs
oom: nxq xxt
jel: xvt caw aek jub
uhr: eul
ygi: you
jrx: dyt xnm zci
iiv: wwn jny vxv rig
itg: out
cle: uhs prx
und: ucr ead
cuc: fim
bux: hdp
ost: khz mui
bbp: fbt
jrk: czw
zxg: mgv
dxe: vzs rno egy hpz cyh pkp wek zjw mug ukk hfn vnf ihm xik ibf hxi dye
sif: bbp
mfp: vty uec
ker: bbd lmf gjd
wek: zxg kjl ery mbe sya
zbk: otg nkw
qvp: qhf fcr uml snx
nfz: caw xvt jub
wnc: glg fed jqn
cqw: ior wob ygv hdp
ytt: out
dbv: znc
nyk: mmd ngf txj dyx
wda: qmr
dfh: hes
xbj: whe znc afn
dyx: nhk
top: jim sum hxf
ohi: god zzh
wjj: you tgd
qiu: rmc jjh dfv
uks: nfm saf
lcn: vby
avz: xuq
xbz: out
mog: ior wob hdp
fim: xks ayg ocv pwj sif
sum: hje rej
hlb: out
xcr: toi olo zpd
glg: jub caw xvt
vbl: zgf sxr arh
jny: you sus
vnf: ebo ahm
eqo: caw xvt yad jub
arh: yqf cuc edy pbm pld ohi kkz lzd hsn hwc vxs bpz fma rvv poi top
dyc: you
vlr: els
hhg: tcz ciu mvf tap rdf
gis: vkf uhu
wde: daw
iau: hhs nyk
uki: fcv ibc loj
yht: xvf
abj: wnw ttk opy
mvf: etj hlb
pkw: xvf
ihk: kom
lcc: yrr lcr
anr: sus
cmh: out
gsr: uva uec fpq
wwn: sus you tgd
sgh: kxy
kyn: edt
afa: kmx eeh dwi gre cmh
xuo: eqs sbo
zjl: bmm nxq
ptq: xdu tak
kmx: out
irk: gsd afn
rdf: can
byk: sum
gkv: dlw
utu: you sus
dwx: ose iua
dwl: nfz kfu gzr riy
lju: xvt caw yad
lin: apo dwx ygw uxb
zwd: nxq bmm
vxs: fim rjj
gzr: caw xvt jub yad
ixs: byc yxr dmi
lvm: vxv rig wwn
ier: fju
hfn: ery sya
wqv: xdu tak xvf fbt
zci: iim wnw ttk
jqn: jub aek xvt caw
ucq: omi mdu
djf: nhk
abb: rxz arq
byc: mtf wic eei
jim: wqv hje rej pkw hbr
ont: you
ulv: tgd sus
wfb: jub
ucr: zzu
ybw: nxq nhk bmm xxt
eos: uhr ucr ead
wfk: ajq qdc
lzi: whj
mqb: ygd fxk
iek: nhk bmm xxt nxq
dtw: xxt
qsc: fgc
mvk: wfk cmw jwt
owy: out
prx: eli
ttk: sus you
poi: vcd lkn vmm
guj: out
dhr: sje sth hhg
chs: xfy
erp: bmm
xsy: xks ayg sif
nhh: sus
yrr: xdu tak
egt: out
duj: uim frn
eei: bmw qiu
sgq: sbt xfy
nxq: zdz ujc xzm hra wyh hwz efj
xxt: uki hml onq zdz ujc myb qvp gis snz qqf dfh wyh xzm hut idt fws drn uvv
ukk: ocu
