nhp: kvj shr dpz
bcz: vvd
rsp: mch xnz jnm mzb vgb
qtp: krs hhn qvx rlk
qql: fmr lbb pcf hdx dvl lzt
rdl: vvx
bzv: dzt qpm hkk
bls: kcr
mqh: qhb zgr llb zrn
jmr: qfb gxk
bcl: sgm
xrj: mhx pfz hgs
jnx: hqb qsz ttq
hhd: szg hzt
hnb: mqg
dpz: gcd crs gjp
kqx: bfz gtk
xld: rvf jlg spv qfb drd
qmk: ljv xpt szc jdc xht jjh
vnk: rfl
trk: vzz
zdn: gnh nqm
hls: kzc gqr dxb htj
hcr: jvf lhf jnx fcj hmz
txp: jxx ltn szt clk tpx
nrq: tzt
phj: zcj vmd cht tmz
gkd: nft bnn qrj bjv
phf: dpl
xkh: xdz gdz nkh
fvt: vpv
hbq: qtb mhx scr srq
qfd: xmq tsc zml ttp dch
sgv: lld
lkg: qrb
fsz: qgq lgr
ztm: jzm ztn
tpt: fgz
pmt: pfm nnh qzf
szt: frr
kmq: nrr qks lzc snr qrz
tnb: mrq tbp tnf ffl qjq
ljx: mns sgm fbc
xmq: phf sjh
qbz: svv
lrt: fnz rsx
jzr: hjg kst jnm
xrv: dhl fbc psx tnq xtf
tvp: nkv
txg: gcp
btn: mzg lzn
flp: xfg zqj vcq vdt dpk kcd
cfb: dmp dgn sxl vzq vzv ksd
rmh: zrn clt lzt jxt
kxq: xdz fnn zxl rdf
fvd: pcf rfp
lzl: mnt skm spq
mbr: htf pkn rtn gkk
dkp: fbc ftc ggv
ddv: czg bxt hcg
jls: pcb pbt hhh
vbk: hzv dfc gkf
xqs: ddk
zkr: qss fhm ddl dtn
cvr: rhd ntf lvq pld rmn
hcl: kkh lvs
znv: jzp cbk
kzc: bkg zdn cnl dtz
gcd: lxm
pjz: qbv
dgt: crs ndg hkj rmb
mjq: vvx ffl
jkx: tpm
lzt: lsh shr ngv
svl: hfc lxm rfc cth
hbx: smn
cqm: btk gvl pdz zsn
nlj: gml xfs sjh blf
krr: pkq xhg mlp kmz
fbb: nfn zck fnp
xrm: xfs qts bkh
kcr: zhj gfn
jjd: htg qlc cnb
dqr: kqt skv
dqc: hst zhc gfc cnp
nxr: pvp fhz hch
thd: bjb frq svf cnd
vqq: hlp hcj cqr
xsl: jck jkd xqx ngs
sls: czj jgh mlv gtk
nnh: lqq hgh
tfk: tfb rbg hdb
zbs: qfh
nbv: sth
jvl: vdg
bjf: zjd mvv jlh fmj ttr
fnn: trd
dtn: lgr
rdz: xgc rpr smh xjq dqr
qkq: dzn xvx hcj pbk mbh
vpl: krf zjx
kgp: fxr dtn fvp mbg
pdg: qjq zjt zrz xgj
krf: njm
rdr: dml
pfq: scp btf jmn fkp
pvc: tbb fbv slt hrh nqv
lzp: bjm glf skm
hnq: ppv dgv qbr
zdd: hpz gfc mbh ssd
htp: shs gbt lrt jvq jlj
cvt: lsc kqm tvs plp lcx
xdb: qjz ztm kzh jmr
gzm: dsx gln qjt
dtj: stf hpj
djn: gxk
vbc: dnb hnq bcz vmr
cpd: qjg mtk ctz ljg
jzp: ppv
jhm: sqk mpc zvx pmt
vzv: tvc cbk
psx: kgm lzn xjq
pll: thb nnh
htg: nft stc
bfz: csb
bpd: gml ggv gfd qgj
btr: msf
qfg: pkq rcz
mbh: hpz cqr
fst: zlv jzm qrz kbl
bsx: ttl dlv tvp bjv drd
pqf: ndz prr rmb
ckt: vgb blc dpl czr
rrk: mhh sfl hjx xnz gdz
ssp: jdc ttq bzf
csm: nzc
mqf: pnr
prz: bls ztn bpq hvp
ndp: gpx lkd kdz
pvn: prz dnr
nlk: cth pgq
qpb: bzm gqf ffm dpc
gfd: scv qrb cqr
jvf: shb gjl
ddz: tnq gqf
stc: xxx flc npr
xsz: gbt sqh
gpq: jdk qbk ggt rlg tvp rxp
rsd: trk
zhv: hkj svf jxt ntc
xnm: nzc mbg mnx prr tvs
kkt: dmz bbb
brg: mgr qgh tnb ljs
bpz: czb sng srv ljq
jkp: lds tpx rbb smh
xdd: dpq qqm sbk
blf: rzh nnz vzv
jbr: pnl plk rcz tmq
mvv: msf slq fgr
bms: dmz
xnj: cth nhq prc vsx
sfv: sng vzq frg ppv
svh: qtt kbv hrs fvq qbq
slf: pjz
xrb: xnq spb tzf bms
crf: pfl krs lms ltv rtn
tbz: rdr spv spb zbs
zqb: qbr jpf qsr
fmj: sqk bbk
qvx: sqk srq
kxf: njm kcd snx
mlp: jzm vtx
qdh: pdq
xmd: qbr
blp: xht nlk
skn: ddg qjz
vzz: ksp cnd
zjt: rtc
fzd: mzj rjk klq
mgm: dbm
spq: nzd
rmn: pvf pgq ncf
nrp: csm njl qtt
xff: hkk qts ktj
shf: tct
hcq: rpq lpk hnq
nvd: kkt
qjq: kzm kdd jbm
ttj: fnd rsg tbx
cjh: sqh
glb: cqx jmn qjr
zgb: jjc tzj njd
vrc: jjc mfk trk
ntd: cnc klj fvp plp
fgp: dvd ncd fvd vgx
vqg: ncl bkg
kkp: vbv lld
kbv: mcb vtx
nzs: xhn grh mgm ppq
zlv: ncj fvd
mxb: ssk xvt
scp: bjb nkz mqf
blm: dfr cbz
gxk: xcg
pbk: mhb stj
vjj: btf lvs
xsg: gsc lfq dkv qhm xpd fgr
xnx: qrd
drm: qtt vml
lps: tfb fdg lxm qdz
kmg: brp vzq fcg lxf
fch: kzs qvx bsz qxf
kzs: gmg
rss: fsc cxb vtf sqp xnm
tpv: klj xxs zmq qqd
zqg: jsx
vzm: mjf vnk bcf
gkf: hkl qks pxh
dpr: bhq
ldz: kst vjn kcm qrb
ckm: xqs
qzk: jcs kst vpd hch
dfc: bmd rjq ngt
dpq: nzd
prj: bxz fdf lzt
hdd: cgg
thh: pjq vpv gnh
fjp: ckd rrc bsn
pcj: rpb cpp lzp kjq
slq: hmd
jhz: zcc kcm nmg lzn
ghx: jrs
zsn: mrm
ldp: vbv
qjz: dck
qxf: flb
lbn: tfq hfc zkc
kkh: xqn pkq
dtx: vtj ctz dpr
mgz: rpb pgq bjv
lvl: lzn
gcb: rjk gnm xmd
xmc: szt mgb czc crz
bqp: kvn jsb rxn
dch: hhd btq
xjn: pll jcm dvv bbk
mjd: fzd kqx bmv kkv
vmr: gkk vxt
qcf: fht
kvq: dgg msl xdz gkq rzh
csk: gkc nvd mbp
bhr: pcf
cht: vjr xcl nvg dvm
slj: ljv mhv rjf xlz spq
dvs: qbx pcg lfm bkh
grn: kpv ljx bfz szg
tcf: bls bzs ncf
tgb: xpj gbk xxv
gcp: cbs
cnp: tgb pll
mfk: qbv xgp
dbq: gtk sng nkq fqt
fgt: gbk bkc
jrd: fxr
zrf: qbv jtc rsd kxc dmr
mvp: fls tnv pcf
btj: stf fmm djn jvl
mqt: lqq xvx njm fvn
vpv: lds gdz
qft: rfl
pkn: mlx dkp
snl: jdc skm mxv bxn
mrj: rqn trk zrz lzk
cxb: dgt njl drm
qhb: zvp qjt vzz
sth: zhr
nhs: tbp
gsd: tbd plp rrm nht
qnf: ngt mtt
csl: cgg bkg
cnc: gxv
rpk: tsx ftf clt vtf
xjq: fcg ldp vvv
hnj: dtn mrq vzg
nnx: lxh stf ndg
lhh: pmg jmr lzk
vvc: dkd zvp
thb: kqj
fvq: dkd
ktq: czh fls spv hfn
gxd: tnq
jhq: zmf bnh lsv spx
drf: prk kvn
nbb: qcg skm bnl qqc bbf
bkc: gpn
jsb: scd
gbl: lqq hdd mrk zjx
ffq: bmn blz hgh
ljb: gpn kqj hhn fbc
fcv: qsz vvc tbz
zjh: mcb
rbq: lms btn zjj
cnl: lgx
nsk: fht rjq lcx fmr
xjk: djp jbj lgz
skg: znv rtn ckd jjz fhz mch
nrn: xpf tfq tpm
vll: fkd fgt
jfr: gsc gmr jjf krf
tmh: dpg pld
bsz: lfq snb
qhp: hrg dbm ggv hlh
lzk: ddk fvq
czh: kcs vtj hzk
tqb: gmq hgb gmr gvl rsx
lkm: txg fgz
smh: czb
hzn: fzg skv mhx kcn zjx
lzc: bhl snr prc
pxb: lqq
zmq: dpz
gsc: hjg hbz
kcm: nkh
xrx: dpr qfh
kmd: pxl
xdg: rdf
fdg: blm vgx drd
hbj: qpm sjf sth hbz
hlp: ssv hdd scv
zrr: bcz hjg
znb: mfk
xfs: xdg czr mrm
hnh: rbg jqq rdl
sgp: jls lzp cnc czl
rqq: hjx tzt lld
xxv: ztl dpv
fhz: vvd tzt
hdz: xxx rdl hzd
jjh: dph
zxc: hdd tgf pkn hbq
ffh: mqb zfm tgf
kjq: xpz psk ppx
pbt: zvp
rvk: xpz hqf kcs ncj
zjp: bpq bsg tmq
vtj: kfv
mnj: zjz qfz qjr
bbk: fjr
zrz: kmd hdx
tkf: mns
jmn: ztn
xvh: fzx kst lgp drb
gqc: rfp
pfn: kcm tmz zbh tqk
nct: tgf
szg: kbg xdz
qrn: xgl fnn
bnn: xvs
mvr: qts hpz nvh fgz zjd
hdb: hhh
frq: jmn qrz
bzc: qbz bms xqn
flc: hbx kmd
fqt: frg
ljq: cvf fdq gmq
zmf: tfx stf
sxl: bmv
xzf: dvp ljr plk jrd
kcb: mmh xrm snj
mgv: pxh bbl
scd: ztn jbj
mlv: mhd qsr srq
gjl: fvq
zcj: bvr qch
dzn: nvh gml drz
nvh: jsz lkm lfq
rfc: ggr
hmm: pxl svk
kjb: zkc gqp xgt
bbx: scv btk cvf lpf jsp
qhm: cgq lfl gbl
lbb: qcf xqv kcr
xzb: fzf rbb cjv mzg
ntj: ldp rtn
bkh: mqn
shr: ftf vsx
zjd: gfc zhc
bzs: kvj lgr vjx
rnf: drz blz dpl bqb
bmn: zhc
xsh: tsg szc scd xqs
mrl: hjq xsh jxh jhq ngh
gqm: xcl zzb
czl: ppx qjx
sds: vhz grt qrz bnn
dql: jsx lvl tld fcz
gmg: qlm pjr
kdd: xgp
xnr: rqx qdh ddh
njc: bls bhq gck bjb xcg
crt: czm kbl jjh ngj pfj hqf
ktj: mzb
vdg: xht
dvb: lzz
mcd: shm rkd skn
kjx: xcl hjx
hdm: qvd vqq gmg mqd xnz
qbk: xpf txj gkc ssp spx
xqv: smn
rps: ctn kkb tml
mcx: rpb ckm
sjt: hpp hgb sxv rrc
hpj: hhh slf
jdc: mxv
msk: nhs
bpq: tnv
hgb: ksd
dxk: zxf rnh zjh
xcq: hjx tkf rcl knv
qmr: bvj
lsc: jbm vgx
kpc: dfr qbq qgq dlc
xfj: rlv ztv skn vjj
qss: rpb
nbm: ghx
zzt: gqf czj thh fdq
qzf: hjg khs
dkr: stj mhh gsl snx rgt
srv: vht kcn jcm
bxz: lhh xgp
slt: jkp tmn
dlv: vhz xfc
gnh: jqh
pcg: hdn
shh: djn qlc tbx prr ljr
scv: zqb rsx
cqc: ljg rtc ttj fxr vhv
fsv: qfb vxp zlv pxl
plt: bbz dpl qdr zcn fdq
jtg: zqg trd
jsp: cnl fkz
zkj: ggl xbt rbb jkt
tpk: qjq kkt ngh lrk vfc pbt
hch: mlx
kkd: vlv tnr zmf lvq
hsv: smn gxv
rqx: bhq
cbg: bpq cth mkv
jjl: mcb rxn jqq rrt zqr
dns: dlz jjc
shb: npr ddg
rvl: xnq
bcr: mgm szt btk
nxt: mgm pxb
bzf: qzx zxh xpt gjg
vkb: zjh nvk fvb pnl
spb: shm
szc: lth kxb
npr: zhj
tzm: kpv tmz fcg cnk
kcn: bvl
qmp: xdz pcd fvn vgr
ppp: rbf fxr msv bqr
bkg: qfp
jkl: lzl xgp clh kbv
tbp: pkq
mrp: pkq qjq pqs qrd
mrq: hhh xnq vzg
cdl: chz gmr cqz srq hhk
fgb: pjc mcx zqr hqb mlp
clj: phf jlj btr
njk: qks gqp lgr xpt
gkq: rjk fkz tld bkc
xrn: pnr tnf
kdc: hdg hdn fgz hgh
gdg: qhf jfd gpn
rrt: dml
vnq: cpz xpj svd pqj ddb
ttp: vpl jvz
fpj: fmm vvx dlz fbh
smg: rsp jdp ltv xtf
dfn: ddb vgq
kkv: jfd
zxf: ppx
zhc: dgv
zrn: ksp
mtn: nrn jnr xnm gkc
bdc: qtb mqb kqx qmr cgq
nks: fdv mnt gnb fls
fcg: vcq
bbn: msv nvp lxh
dvh: hdg gnm rdj cmh cbs
gbt: sgm
fdf: cth kpm bxn
kjl: kpm brg spq chx
gbb: qbv djp rfp brg
cjb: tnf ffl
jbd: zkk jlg dtj
tmm: zmq dns qgh qcf
tzl: mhb qbx frg vqg
dml: rjf
rkn: dgg gsb ghx zjj pxv
tfx: xgt
phs: vpd kcn ggv cjd bvr
hpp: kjx pkg kst
vmq: jhd hch dnb vrr
hhh: gck
jgd: bns bcr hst hgs
ljr: gsp
bzm: hjg spp hgq
mlx: zhr nkq
rjt: fdh fmj
msp: nvd rkd lzz rcj
xfb: csl rhg hhn
tfb: shm
zhx: bps hkr
nhq: sbk qss
qmf: dzl jhd tqk sxl
vpp: gkk
rdc: xnm pgq mcx zhx
jlx: bjj lkg dgg lxf
vmd: bvr
lsv: bhq kfp
kxd: xpd srq vvd fnz psj
dxb: lkg vvk mrm zqg qsr
mpn: vml pmg frq bnn
qsz: hxj
tml: svv bhq
mbg: xrx qjz
xlz: fkp pxh mkv tbd qss
bvj: sqk czb ssd
ttn: fcm kzd tfx
pnz: gcb rcl dcv xmd
hrs: blm plp rmb qjx
jqk: hkr xrx zcs jbm
szs: vjx ljg hsv
ndf: rbf snr
zjn: npx fnb gcn jrd
lfl: dgv dcr
ddg: kzh qfg
prk: dlz zjh hkg jxt
xxs: rqn hxj tvp
jdj: htc vzg
zck: fkz xfg
ncp: nft lxh xqv
msv: djp blm
hnz: vll tpx bsz bmn nct ddv
zzc: qsz csm mxb
hdn: snx
mqn: blc
nrs: cpz gcp mqn hgh
rmv: flb zdn zcc fgg
gkn: kjv mpc dpk tmz
sft: tsx gqc xxs dmr crr
vvl: ngs cpz nqm
ltn: bcr tgf
jlg: kbc
tjl: gzr lbn bqr dbh
nkb: nkz bms qjx
hbz: zcn xpj
mch: kjv
gjg: bjb kxc nvk
qqc: kxb glf
ltj: ncd pbt gck nlr nlk ctn
gnm: mqd kst
hcv: gzr zpf ngv mcb
nzd: ndg
srq: fnn
ztv: ljs pjz mlr
vvv: htf flb
kgs: khc rmf jsb mgz
blz: qts vbv
mnt: qjx khc
bkb: bjv qsz hnb
ndz: bpg tfk
htz: hrg ndp psj tvc
qjs: kfb rsd nvp nkz
lrb: qgh
tmb: bvl vll jtg
bjk: vjf mtg dvp jqq mvp
gsl: hjg
drz: kpv qhf
lkd: bfz zqg
vgg: ncd kkh dvf hnb
lpx: jvf qlc kgx ttf
fjf: qgj msl jqh
kmz: rqx kfv qjt
spp: ssd bjj bvf
qgj: trd
bhl: gfn
dfl: sjv zrr jnm dtc
rtp: nkv lgz qsz
sdt: sgm jsx kjv
jvr: scr njm mnz dpl
gnb: cfz kbv vlv tgp
szv: dnt vdg lvp clt fnb
ptc: nrp tgp ksp nhs
hvh: dxk kxb bsg jbm
mqg: hdx stk
fhs: rcl vht gmq
htc: jxt dph blm
qgb: dtx dtn jkx rpb fsc
bjm: bbl nzc
xgv: jbj jvl qvf zbs kmd
sjh: gqm pjv
hcp: jfv ngj nht kzt
rhd: bbl ttl sdx vhz kbc
dfp: sdx bzc svf
rkd: fdf
tgp: tbp rdr
dvd: lvs gjp
xgj: tcf kjb kkt rvl
rkm: kxf pcg gvl tmn
qkn: gbk zrr btq vqg
hrg: lqq hgq hhd
gmd: nvd qnf rdl
nmg: htj pfl psj
zgr: tzf
bps: rsd mrz gzr
kvn: pxl xhv vtf
zxb: vsx glb flc shb
tfp: vbk lsh hkg jdc
nfn: hcg
rnh: ssh ftf vjx
hhk: nrq rhg rqq
rdj: pqj
hrh: ztl chz kcd
khc: kmv
kjk: jlh ggl gsb rmv qfp
rmb: gfn
qqx: hdn htj msf bbz
jzs: xnx psk flf ftf
nvq: ltj gjp gjl
zpj: kdz dzl nfn cbs zcc
rjk: zrr
gdd: jvq gpx zjx sgm sjv
lzn: bsn
zjj: hlm qvd
snb: szk qts
nnz: xdg jlx
thv: pnr cfz xnx
dlz: zxf
nnn: nxt nbm msf gpn
chd: rfp svv bdg xxx hdz frq smn
xqx: ssv nkr kgm
krn: vtj kmv xxs
mpc: lpf ssd zsn jzr
zcn: fdq
dhq: xxx msk drm
zrb: bxn ntc rpb
bcf: bjq fnn
xdz: lxf
nlp: pbk sgv bjf dvm
tsc: qlm vjr
fvn: fkd xsz vgq
xcg: lsh
rhf: ngt nzc jxq
pdz: nrq tnq kkp
lhf: dck
dpc: qrn clj jsx
vvd: vvv pxb
qmz: kgm ljq vgq jvz
njd: kzt kdd zjt
knv: jhd
csb: bjq
cfm: dmr qfg hzd
hkj: qqm
ncn: shf trd gxd jjf
dmp: htf
cjv: mhb zcj
xvx: gdz rfl lpm
vdk: xsz ddz zkj lpf fjp
sxt: frr hcq mgm hbj lvl
rzj: rxn
lvj: fnb ssk hcl rtp qqf kjb
xgt: kfp lvs
cfz: svl fdf
ntf: scp fnj
gvc: bbb jfv csm hdb
kgx: ndf nlk rmf
mgb: mrm
fvb: nzc
ncd: djp qks
grt: mgv
kmv: lvs
mvf: tfb qjx
dfr: qzx qjr
mzh: mgb rgt rlk xsq rjt
fsn: lpz bsh jpp
skm: fmr
cdh: cjh fcz gxd kfd
cqr: kfd
jbs: mqg hmm bpg cpd
gjf: ljx dkv kkv
pcd: csl srq
fmm: ktt jkx zmq
stb: qjl xhk pjq hpz nfn
czr: lzh
ngv: fvb
lfc: gsp gqp bpg
jxh: rjf rmb xqn
pfz: mzj rbq fph
pnl: prm mbp
rdd: jjd zlv jjh mhv
hcj: jrs nvg
zqj: qpm fzx hcf sgv sjh
qtl: xvs rtc vgx
lsr: mgz crs djn nft
txb: ztl xnz dvv qmr
mnx: jbj zhj
kbh: tsg ggt rqn crr ssh dpq rhf
flz: xhv bhl ndz sbk
qvf: hzd qjg
kbl: pjz
cbb: xbm nhq mqf
vsx: rlv
zgz: zcc klq
svk: tmq xvs
bnf: sqh gmq bcl
pqb: fvt nct lkd hhn
dss: hqf jlg rvl
mcl: sqr bmd xpz
bjj: jjf
dxg: tvc gbt shs nxr bjj
skv: bcl nkr
jnm: czg xkh
mqv: scr dmp vmd cnp
gsb: pjr
rcz: ndg
qdr: bjq
mqb: grh gnh pfl
fmt: xnj cqx rlg jnr
zxx: lfc zrb svh xnq zrn
ndg: zxh
xbm: qfz xpt rtc
scr: nvg
ckd: tkf
ldh: hkj stk
ljs: ssk
qgh: hcn
rnl: bqp dsx lgz cbb
kcs: ftf
xgh: pbt jmr dns gln
fnp: jrs rfl
hgq: btk lqq
zsv: cdx ntj ggl pbk
khs: ffh jpf
dhl: dvm zqg
pfm: vjr nrq
ncj: ncp tmq
tmn: sgv lms
bmc: bqr rbf hqb cpd fsn
cdx: rdf
bpp: mxv thv vvc tmq
xzg: vvc gxv stk
tbd: bbb tpm ljg
sjf: nkh
mrz: fht qrz
hhb: gcn ggr
qlm: qfp
hjl: ggr ljr lth szv rrt
fsj: nct bsn
krs: mns
dzl: qbx
dvv: smh
zkk: dns jqq xhg qzx
hgs: ztl rjt
mhv: shm xqs
fdv: vlv
ndc: fvt gqf nkh pkn
msl: gcp rvc
fmg: vlv lvs zxh
ttf: crs
ddl: lvp qtl gck smn
hlh: dbm shf nrq
sch: hxj nvk jxq
vxt: szk stj
dhz: tsx ttf prv slf
jkd: mlx ndc
fnv: fsc kzm ssk
clk: drz bjq nzr
ltk: vjc rdj qvd smh
jqh: vht
hjq: dtj jtf spb
kkb: sqr mqf ldh
rsg: snr jvl ntc
kdb: fjr kjv
nht: jnr mgr rcz
lbj: sfl zcj xhn qnx
lth: drh zlr
dvf: vvx kfp
qjr: fsc
vvk: nmn pcd qdr
mnb: sds tmh lhh sch qvf
zgt: zfm thb
pqs: qbq cjb tnv nsk
dkx: hhb vjj khc bsx
rvf: nlr qfh ckm xpf
xpq: jkx qcf
bnl: kvj btf
dhd: zgb fvp fmt qfz
jcm: qxf kqj
hcg: nmn
sqr: pjz
nvg: fzx
stm: kjx czg qgr fsj
ncf: vdg
gqr: rvc vbk chz
tsh: nvq fvb kkd qbk
bfs: gln hkj
hkr: rcj jlv nlr kfb
nkl: bmn cdx ngs
plk: lsh rmn rzj dvb
qhl: xtf txg mgb vmd
tbx: xfc zjz
fdl: kkv zhr qxf sgv
fph: stj gnh ftc
dsx: kfv bpn
crr: tsg pnr
qcg: qbz tpm zlz
bgg: kdb dzl cjh krf
dpk: nkr zml
tvx: fgg fkd mbh lfl
lfm: gpx klq ksd
dbc: fgr cdx zhr vgr
fhm: xbm vtx mvf fmf
vfc: fmf vmv rfc
vjd: prv vdg jjd bbq
gmr: thb
xbt: jjz gkk khs vjr
nxq: tkf sqk frg xxv
vlf: jdc qqf ngj dss rkd
czm: bnh jbd pzk
hpz: jdp
hmd: qch mmh mzg fsj
tsx: cjb
ndh: hdx trk rxn fjk xnx
flf: xrn dvb zhx
nzr: vpp vpv
pgl: zqr ngh hsq lgr
dsg: sqk xff nxt nbv
njt: hqf bfs jpp bpn bhr
dpv: kcd
qbl: dbh stk
xkf: vjc kbg lfx mmh jkp
jgs: lpm jjf lxf
tkg: zxl qbr tpt tmb jsx
gpx: zml
pmg: pjz gzr
hdx: rcj
xvs: dlc
shg: xhv nkz qnf tnv
gsp: ksp rpb
klj: scr rqn
bnb: bjm gcn rrm
rjn: vpv qtb tkf bqb
qhf: bsn cbk pkg
pvq: dkd hqb kzm ltj
pbp: bfs qbl gjp ttq
mhh: jjf bcz
prm: fmf gjl mtt txj
dkj: tbd kmv prc gcm
fgr: sxl nkl
tsg: ctn
svn: cjh tbb blc ndc kdz
xvl: kfp pvf fgp csm
grh: frr
dpl: dgn
bnv: vxt qtb ssv
kgm: gtk
jvz: mzb hdk
kvb: fgt vpd kkp fbv
zlr: fht
bbq: kcr mqf grt
knp: qzf fss sjv qfp
tld: vht fnz
nlh: znb svk fnj
hzd: zlz pxh
cgg: czj
gtj: vhz
cvf: zrr xmq
fnl: ljs vzg jtc
gvl: pjr
mxv: pcb
kvj: bls
zcs: bbl gtj rqx
bns: nvg ktj qvd
bmd: xqv
hsq: ncp hcl xrb
cpz: fgt ltn
tnr: npr tfb gxk
sqp: tml slf
lpk: fbb txg
kbc: xvt cbz fht mcl
fjk: djp kcs ldh
svf: mnt jpp
dtc: mrk drb
mtg: svs zlz bdg cbg
crz: bzv sdt hst
ztf: nhp lhf jjl mrj czh
qbq: ddk
xfg: dfn
qgq: ptz
pvp: mjf pcg
cjd: shs fnp
ggt: khc bjv
vgr: nqm gcp
llb: fcv xvt rjq
jtf: ttf qjr kzm mhv
mlr: dlc hdb hdz
tmt: ztm xgp bdg
dff: cfz dfp htc hcl
xhv: dvd
pbd: ssh tnv xnr ctz ztm
jgh: cgq dpv qlm rgt
tqk: slq jsz vpl
zlz: hkl
bvf: jdp lzh sxv
jcd: ngt jtc htg fvp
zxh: pvf
jnk: zgt zml kdb
rrm: hfc tbp
fnd: dlc ngh tsx
ftc: nmn hst
xmk: grt fdv snr krr
nrr: mnx kxc xpz
bqb: jpf
bqx: pcb dtx qbz mgv
cbr: cpp pvf zjt lzz
ggl: nmn stb kfd
zlp: lgx qjl dvv pqj
rzh: qrn bkh
czj: mns xgc
nsz: ptz dnr xrx
mql: ksd chz gmg qch
fkp: jnr
nvk: lxm
xhk: pkg dvm ggv xcl
cfk: dph zvp ngj
kzh: tfb
rns: cfk qdh csk dpg
prv: msk gqp mkv
fss: vmr lfm ntg fsj
zdt: kvj jfv tmt hkr
hvp: vps fsz mrz spv
nzc: dbh
qrd: snl glb
ljg: rqx
bbz: nbm gmq
cmh: nmg rrc dcr
clh: kfb lrb npr
xtg: dch nkr ttr psj
lmg: gln qtt bhr hkl
fvp: vml
ddh: mkv kcr znb
vjr: vnk szk
lfx: jhd lld fgt
rgh: qqm pvn rdr dsx
tpx: zzb
mcg: bjq nkh hjg
glf: fcm cth
crd: scr snj qmr mcg
jfm: nxr gvl pfl xcl
hbk: xxs qqc kzh rmf nlr
hkl: hfc
hzk: dph
qjm: chx blp dpq
jlv: hzc zjz rfc
hzc: nkv zjz rqx
stj: pxv qtb
mzg: rdf
hxv: grt gcn xdd jmr jxq
ntn: xjk vjx srs gtj bmd
ktt: dml jlv
jrq: ntf mcb cbz
bxt: ttr vjc tbb
qjt: ffl drd
jxx: jqh kzs jzp hps
mhd: hlh drb xfg zrr
htf: czb
dnr: crs
bkp: rqx kzd qbl ncp dmr
kbg: rqq
rbb: qts
xpd: bcf
pmh: gmq slq bnv svd lpk
vrr: fkz ffm czg
zbh: lfq czj gqf
dvp: qfb gxv
pjv: jjz mch lgx
tbb: fhs dkp
fbh: zlv kfv
zkc: rlv lgz
dzt: grh ntg rcl
bdg: fvq bxn
zqr: mgz
tzh: bcr ljb nnz
kht: mkz jrd drf tvs
bqd: tbx rvl sqp ptz
lgp: lzh jcm
lgz: kdd
dcv: sjv
mlc: ctc cjd bsz ftc hch dql
snj: kcn jnk czc
rbk: znv pjq plt tzt zgz
srs: zbs xrn htg zlr
hcn: pnr cnc hdx
rpr: tgf dkv fnz
pxv: ngs
lrk: prc glf tzj hpj
sxv: vht
xsq: mns grh nqm
jlh: lms czr
sdx: ntc jnr
rlk: dnb cgq xpd
zjz: xfc
tzj: qfh gkf ldh
chz: xmd
pkg: knv
rpq: zgt btq dgv
btq: nkr
slx: rdf jkd dcv pfz
fgg: snx vht
ght: ncl dcv gdg qjl dqr czb
lft: mcd ppp fvp lhf
rxp: jqq zjn
fzg: vnk dmp qsr
cbz: rxn
vtf: vrc gfn msk
ctc: fgt gsl fbv cgg
lxm: dkd
mqd: fzx
src: rvc ddb vpd
jpf: qbx
qdz: fbh ksp dpg
ncm: vzm rsx hgh fvt
ktc: qdr xcl bkh lrt
ppq: mjf xcq thh
nqv: bmv jfd rnf
brn: dvf bnb ckm jtc
fcj: ppp btf spx jjc
mzj: vvd pjr
mhb: kpv
hzt: vdt sxv lkg
hpl: qhf gbk nbm jjz
jpp: dmz gtj
xxh: krn xjk gnb
tqp: cpp rxp nlh bxz
zdm: cnl txb vmr htj
zxm: kcb zcj nkq fzf
mkz: vps fsz nhs lxh dtj
cpp: plk
txj: rfp
cqz: nbv csb lzh cqm
dpj: dlz fmm drf cfm
qlc: dsx
drb: lgx jsz xvv
vmv: xqn mgr ddk cnd
cnk: tsc tpt bcf kdz
chx: tmh qqf fmr
sng: zcn
kfd: lds
ssl: mgm pxb fqt jsz
bsg: clt tfq
qnx: bbk zfm xhn frr
kfb: kbl
dpg: gxk mjq
brx: fls qqf mxb mtt pxl hnh
dkv: vgq
gqf: fdq
fxs: njd hxv zlr rps ndf xpq lzz
vxp: rrt tzf rlv rzj
tgj: bbz btr vvl gsb ttp xff
mvq: lsv jdj njk tfx rbg
xpf: scp
cnb: ncp lsv lhh
gkc: vzz
hft: gfd slt gsb
hkk: msl ckd
vdt: rgt
kxb: rvl
sfl: hcg vxt
ffm: bvl czg
mnz: ffq gmr dgg
hkg: mgr vvx
dnt: njc bpq cnd
ntg: ltv cbk
vcq: zml sqh
kxc: kzt
nfr: dlv qdh zgr qqm
tvc: gnh
vjf: ngv qjm jsb hbx
sdv: hcg mxv vpp hdn
lpf: hdk
lpz: nsz rdr fnv
zvx: mzb srq btn
mtk: ctn pcf hbx
fnb: fnl
jfd: jdp
vps: qjg qbq
ttl: xht drh
dqm: gkn gdd jtg nbv
mts: gqc txj hck dlc
zpf: djp rjf fmg
mrk: vdt
pff: vnk fqt xhn jsp
xgc: hdn rsx
tnf: fxr
vsn: qjl qft krs cbs bcl
rbc: gmd pqf zzc jrq
czc: fbv klq
blc: fsj dgv
xhh: hgb ftc klq kqt
pzk: gqc dbh bbb
vgb: xpj jlj
hps: kgm gsl gml lkm
ddb: bmv
rlg: tfq
fcm: xvt jzm
kdz: bcf
zcc: fjr sth
rrc: fzx bvr
hzv: hmm ssh rmf
gsv: klq frg qxf msf
xgl: bqb tpt pfm ghx
dvl: rlg xzg mcd
jdk: jdj kvn zxf
hlm: njm qvx pvp szk
qrj: czl mbg nvp ctz
lcx: vml
bqr: qqf
qqd: hnj lrb ntc
jzk: cjv xrj lvl xmq xtg
sbk: xcg
kqm: zjp ktt hzk
tvs: mvf dnr
jfv: rtc
jkt: qsr sgv shf
mbp: qzx dck
hzs: ttn kzt hxj gzm npr
drh: gqc rhf
tfl: nkl qbr hdk jnm
lpm: jlj dbm
ccc: dmz zlv gcd slf
tsm: bkb dck ptz mrz
tfq: jnr
ksd: lds
vhv: rbg lrb zrz dhq
bkx: rcj dns xfc dtx
kqt: mjf
tct: fkd szt cdx
jcs: tsc qhf szt
dnb: vbv fjr blz
qpm: jgs
qgr: bvl jrs ldp
hfn: bhl plp ncf
psk: rbf dvb
knx: thb dxg tzh dtc
xdc: zck lzn ddz hdk jzp
vjp: nbb hhb qfz dsx
mhx: btr
bpg: ngt
lvq: hzk nsz
dtz: gjf kzs mzb
jck: brp gqr gmg ttr
hfm: flb ssv dgn vpp
jxq: kdd
bbf: fvb szv gcd
flh: qft csb kqt rdj
hdg: sjf vzq
cxx: ntj ssd dvv zzb pqj
njl: ggr qjg nkb
mjh: mqd src pfm lgp xfb
hck: xqs kmd qnf
xph: fkp pvq svv fdv prj
hcf: htj kqj fbb xtf
svs: qrz spx xxs
ngh: gjp
pgp: blp xxh bhr qgq
vjn: snb bfz nzr
npx: znb pcb nvp
rpb: bpq
krc: zxx bpn pvn gbb
fzf: bnf pxv vjc
kzd: tnv dpr
kst: rdf
xhn: ltv phf sqk
rjq: lcx
thj: mmh hft mrk dch
gcm: xqv hsv drm
pjc: tzf ppx sqr lsc
svd: ktj kbg zzb rhg
ppv: vcq
cst: btq bkc dkv qch
ncl: qft shs
xhg: bpn rzj
nkr: zfm
gfc: sjf pjq
jvq: nkq sjv
fnj: vtx tzf bnl
bnh: nsk lhf
cqx: cbz mnj ttq
bsh: ptz zgr qfg
brp: zsn hcj
zxl: zgz rhg fjf
ljv: jbj hnb
pfj: vtx pld nnx szs
lvp: pnl cfz
kpm: xpq mgr
nmq: sng qrb dhl xdg qfp qgj
pdq: bbn fmf mjq nzd
hmz: mtt bzf drm
fdh: nkq mqn tkf
fcz: dfn knv
nkv: zhj pld
rvc: dgn
prr: mnt
dcr: gxd zck bqb
xvv: dpv jzp gqm
